#####################
#S#.............#.#.#
#.#############.#.###
#.#...#.........#...#
#.###.#########.#####
#.....#...#...#.#.#.#
#####.###.###.#.#.#.#
#...#...#...#.......#
###.###.###.#########
#...#.#.#.#.#.#.....#
###.#.#.#.#.#.#######
#.........#.#.#...#.#
#########.#.#.###.###
#...#.#...#.#...#.#.#
###.#.###.#.###.#.###
#.........#.....#.#.#
#########.#####.#.###
#.#.......#.....#...#
#.#######.#####.###.#
#.....#...#.....#..E#
#####################
