##############################
#     N #  P        #        N
# # ##### # ####### ####### # 
# #     # # #   #   #     # # 
# ##### # ### # # ### ### # ##
# # N   #     # # #   #   #   
### ########### # # ### ##### 
#  T#           #   # #     # 
# ### ############### ##### # 
#  P# #                   #B  
# # ### ##### ####### ####### 
# #     #   #     #   #   #   
# ####### # ##### ##### # # ##
#  A  T   #     #    P  #     
##############################
