##############################
#     # B   #     #           
# ##### ### # ### ### ### ### 
#       #   # # #   #   # # # 
# ####### # # # ### ### # # # 
#     #  N# # #   #   # # # # 
# ##### #####P# ##### ### # # 
# #  T  #   # #    A#   # #  N
### ##### # ### # ##### # ####
#   #   # # N   #     # #     
# ### # # ########### # # ### 
#   # #   #     P   # # # #   
# # # ####### ##### # # ###P# 
# #           #     # T     # 
##############################
