#####################
#S#...........#.#...#
#.###########.#.#####
#...#.#.#...#.#...#.#
###H#.#.###.#.###.###
#.#.....#.........#.#
#.#####.#########.###
#.#...#...#...#.#.#.#
#.###.###.###.#.#.###
#.#.....#...........#
#.#####.#############
#.............#.....#
#############.#####.#
#...#.#.#.#.#..HH.#.#
###.#.#.#.#.#####.###
#....K#.#...#.#.#...#
#####.#.###.#.#.###.#
#.......#.......#...#
#######.#######.#####
#.#.#.#...#........E#
#####################
