###                 #########
#   ###################   # #
# ####                # # # #
# ################### # # # #
#                     # # # #
########### ### ##### # # # #
#   ##                # # # #
# # ## ### ## ######### # # #
# #    #   ##B#         # # #
# # ## ########### #### # # #
### ##             #### # # #
### #### ##### ### ## # # # #
###             ##    # # # #
###### #### ### ####### # # #
###### ####             #   #
A      ######################
