#####################
#     #   #         #
# ### # # # ##### # #
#   #  K# #     # # #
### ##### # ##### ###
# # #   # C # A #   #
# # # ####### # ### #
#   #       # #   # #
# ##### ### #H### # #
# #     #   #   # # #
# # # ########### # #
# # #    H  #    C# #
# ######### # ##### #
#  C#     # # #     #
### # ### # # ### ###
# # # #B#   #     # #
# # # # ### ####### #
# #   #   #         #
# ##### # ######### #
#       #           #
#####################